- aerosol_can: 喷雾罐
- air_conditioner: 空调
- ambulance: 救护车
- antenna: 天线
- trash_can: 垃圾桶
- baby_buggy: 婴儿推车
- backpack: 背包
- handbag: 手提包
- suitcase: 行李箱
- ball: 球
- banana: 香蕉
- Band_Aid: 创可贴
- bandage: 绷带
- banner: 横幅
- barrel: 桶
- baseball: 棒球
- baseball_bat: 棒球棒
- baseball_cap: 棒球帽
- baseball_glove: 棒球手套
- basket: 篮子
- basketball: 篮球
- bench: 长凳
- bicycle: 自行车
- billboard: 广告牌
- binder: 文件夹
- bird: 鸟
- book: 书
- boot: 靴子
- bottle: 瓶子
- bow-tie: 蝴蝶结领带
- box: 盒子
- briefcase: 公文包
- bus_(vehicle): 公交车
- business_card: 名片
- cab_(taxi): 出租车
- camera: 相机
- can: 罐头
- car_(automobile): 汽车
- car_battery: 汽车电池
- card: 卡片
- cargo_ship: 货船
- carrot: 胡萝卜
- cart: 手推车
- cat: 猫
- cellular_telephone: 手机
- chair: 椅子
- checkbook: 支票簿
- cherry: 樱桃
- chicken_(animal): 鸡
- cigarette: 香烟
- clock: 时钟
- clutch_bag: 手拿包
- coat: 外套
- coffee_maker: 咖啡机
- coin: 硬币
- computer_keyboard: 计算机键盘
- cone: 圆锥体
- convertible_(automobile): 敞篷车
- cooler_(for_food): 冷藏箱
- cowboy_hat: 牛仔帽
- crabmeat: 蟹肉
- crayon: 蜡笔
- cup: 杯子
- curtain: 窗帘
- cushion: 坐垫
- cycling_helmet: 自行车头盔
- dagger: 匕首
- dog: 狗
- dress: 连衣裙
- drum: 鼓
- duck: 鸭子
- dustbin: 垃圾桶
- eagle: 鹰
- earphones: 耳机
- earmuffs: 耳罩
- earthworm: 蚯蚓
- easel: 画架
- eel: 鳗鱼
- egg: 鸡蛋
- eggplant: 茄子
- electric_fan: 电扇
- elephant: 大象
- envelope: 信封
- eraser: 橡皮
- escalator: 扶梯
- eucalyptus_tree: 桉树
- exercise_bike: 健身自行车
- eye_glasses: 眼镜
- eyeshadow: 眼影
- fabric_softener: 织物柔软剂
- face_powder: 散粉
- fan: 风扇
- Ferris_wheel: 摩天轮
- ferry: 渡轮
- fire_engine: 消防车
- fire_extinguisher: 灭火器
- fire_hose: 消防水带
- fireplug: 消防栓
- first-aid_kit: 急救包
- flag: 旗帜
- flagpole: 旗杆
- flashlight: 手电
- flip-flop_(sandal): 人字拖
- folding_chair: 折叠椅
- forklift: 叉车
- freight_car: 货车
- frisbee: 飞盘
- garbage: 垃圾
- garbage_truck: 垃圾车
- garden_hose: 花园水管
- glove: 手套
- golf_club: 高尔夫球杆
- golfcart: 高尔夫球车
- grocery_bag: 杂货袋
- guitar: 吉他
- ham: 火腿
- hamburger: 汉堡
- hammer: 锤子
- handcart: 手推车
- handkerchief: 手帕
- handsaw: 手锯
- hardback_book: 精装书
- hat: 帽子
- headlight: 头灯
- helicopter: 直升机
- helmet: 头盔
- highchair: 儿童高脚椅
- hockey_stick: 曲棍球棒
- home_plate_(baseball): 垒球的本垒
- hook: 钩子
- horse: 马
- hot-air_balloon: 热气球
- hourglass: 沙漏
- houseboat: 家用船
- icecream: 冰淇淋
- iPod: iPod
- jacket: 夹克
- jean: 牛仔裤
- jeep: 吉普车
- jersey: 运动衫
- key: 钥匙
- keycard: 钥匙卡
- kite: 风筝
- knee_pad: 护膝
- ladder: 梯子
- lamp: 灯
- lamppost: 路灯柱
- laptop_computer: 笔记本电脑
- latch: 门闩
- lawn_mower: 割草机
- leather: 皮革
- legging_(clothing): 打底裤
- Lego: 乐高
- lemon: 柠檬
- lemonade: 柠檬水
- lettuce: 生菜
- license_plate: 车牌
- life_buoy: 救生圈
- lightbulb: 灯泡
- limousine: 豪华轿车
- log: 木头
- magazine: 杂志
- mailbox_(at_home): 家用信箱
- map: 地图
- marker: 记号笔
- mascot: 吉祥物
- mask: 面具
- mat_(gym_equipment): 健身垫
- medicine: 药物
- milkshake: 奶昔
- minivan: 面包车
- mirror: 镜子
- money: 钱
- computer_monitor: 计算机显示器
- motor_scooter: 电动滑板车
- motor_vehicle: 机动车
- motorcycle: 摩托车
- mouse_(computer_equipment): 鼠标
- mug: 马克杯
- musical_instrument: 乐器
- napkin: 餐巾纸
- necktie: 领带
- newspaper: 报纸
- notebook: 笔记本
- notepad: 记事本
- nut: 坚果
- orange_(fruit): 橙子
- orange_juice: 橙汁
- oven: 烤箱
- overalls_(clothing): 连体工作服
- pad: 垫子
- paddle: 桨
- painting: 画
- parking_meter: 停车计时器
- passenger_car_(part_of_a_train): 客车车厢
- passport: 护照
- pea_(food): 豌豆
- pen: 钢笔
- pencil: 铅笔
- person: 人
- pet: 宠物
- pickup_truck: 皮卡车
- pie: 派
- pigeon: 鸽子
- pillow: 枕头
- pinecone: 松果
- pinwheel: 风车
- pipe: 管子
- pizza: 比萨
- plate: 盘子
- pliers: 钳子
- pocket_watch: 怀表
- pole: 杆
- polo_shirt: Polo衫
- pony: 小马
- pop_(soda): 汽水
- postbox_(public): 公用邮筒
- postcard: 明信片
- poster: 海报
- pot: 锅
- potato: 土豆
- power_shovel: 动力铲
- pretzel: 椒盐卷饼
- printer: 打印机
- puppet: 木偶
- puppy: 小狗
- rabbit: 兔子
- race_car: 赛车
- radar: 雷达
- radiator: 散热器
- radio_receiver: 收音机
- raft: 木筏
- raincoat: 雨衣
- rat: 老鼠
- rearview_mirror: 后视镜
- record_player: 唱机
- remote_control: 遥控器
- road_map: 公路地图
- rocking_chair: 摇椅
- roller_skate: 滑轮鞋
- Rollerblade: 轮滑
- rolling_pin: 擀面杖
- router_(computer_equipment): 路由器
- rubber_band: 橡皮筋
- plastic_bag: 塑料袋
- saddle_(on_an_animal): 马鞍
- saddlebag: 马鞍袋
- sandal_(type_of_shoe): 凉鞋
- sandwich: 三明治
- satchel: 公文包
- school_bus: 校车
- scoreboard: 记分板
- screwdriver: 螺丝刀
- sculpture: 雕塑
- seaplane: 水上飞机
- shaker: 摇晃器
- shirt: 衬衫
- shoe: 鞋
- shopping_bag: 购物袋
- shopping_cart: 购物车
- short_pants: 短裤
- shoulder_bag: 肩背包
- signboard: 招牌
- skateboard: 滑板
- ski: 滑雪板
- sled: 雪橇
- sling_(bandage): 吊带
- slipper_(footwear): 拖鞋
- snowboard: 滑雪板
- snowmobile: 雪地摩托
- soccer_ball: 足球
- sock: 袜子
- softball: 垒球
- solar_array: 太阳能板
- sombrero: 墨西哥帽
- soup_bowl: 汤碗
- sour_cream: 酸奶油
- soya_milk: 豆浆
- spatula: 铲子
- spectacles: 眼镜
- spice_rack: 调料架
- sponge: 海绵
- sportswear: 运动服
- spotlight: 聚光灯
- squirrel: 松鼠
- stagecoach: 马车
- statue_(sculpture): 雕像
- steering_wheel: 方向盘
- stop_sign: 停止标志
- brake_light: 刹车灯
- straw_(for_drinking): 吸管
- street_sign: 街道标志
- streetlight: 街灯
- suit_(clothing): 套装
- sunglasses: 太阳镜
- sunhat: 太阳帽
- sweat_pants: 运动裤
- sweater: 毛衣
- sweatshirt: 卫衣
- swimsuit: 泳衣
- tank_top_(clothing): 背心
- taillight: 尾灯
- telephone_booth: 电话亭
- telephone_pole: 电话杆
- tennis_ball: 网球
- tennis_racket: 网球拍
- thermos_bottle: 保温瓶
- thumbtack: 图钉
- tights_(clothing): 紧身裤
- timer: 计时器
- toast_(food): 烤面包
- toilet: 厕所
- tortilla: 玉米饼
- tow_truck: 拖车
- towel: 毛巾
- toy: 玩具
- tractor_(farm_equipment): 拖拉机
- traffic_light: 交通灯
- trailer_truck: 拖车
- train_(railroad_vehicle): 火车
- trench_coat: 风衣
- tricycle: 三轮车
- trousers: 裤子
- truck: 卡车
- turban: 头巾
- umbrella: 雨伞
- underwear: 内衣
- unicycle: 独轮车
- urinal: 小便器
- vacuum_cleaner: 吸尘器
- vase: 花瓶
- vending_machine: 自动售货机
- vest: 背心
- volleyball: 排球
- wagon: 马车
- wagon_wheel: 马车轮
- walking_stick: 拐杖
- wall_clock: 挂钟
- wallet: 钱包
- wardrobe: 衣柜
- watch: 手表
- water_bottle: 水壶
- water_faucet: 水龙头
- water_scooter: 水上摩托
- water_tower: 水塔
- wheelchair: 轮椅
- whistle: 哨子
- windmill: 风车
- windshield_wiper: 雨刷
- wine_bottle: 酒瓶
- wrench: 扳手
- wristband: 手环
- yacht: 游艇
- zebra: 斑马
